10 7 60
----------
----------
---====---
---####---
---====---
----------
----------
